#######
#     #
#  .  #
# o   #
# @   #
#######
